{
  "width": 36,
  "height": 20,
  "ground": [
    "............WWWWWWWWWW..............",
    "....................................",
    "....................................",
    "....................................",
    "....................................",
    "..............................S.....",
    "....................................",
    "....................................",
    "...................................W",
    "...................................W",
    "...................................W",
    "...................................W",
    "...................................W",
    "...................................W",
    "..............O....................W",
    "....................................",
    "....................................",
    "....................................",
    "....................................",
    "...................................."
  ],
  "walls": [
    "####################################",
    "#..................................#",
    "#..............l#################..#",
    "#.............l#k...............#..#",
    "#............l#k................#..#",
    "#...........l#k.................#..#",
    "#..........l#k..................#..#",
    "#..........#k...................#..#",
    "#..........#.....################..#",
    "#..........#.....#.................#",
    "#..........#.....#.................#",
    "#..........#.....#.................#",
    "#..........#.....#.................#",
    "#..........#.....#.................#",
    "#..........#.....#.................#",
    "#..........#.....#.................#",
    "#..........#.....#.................#",
    "#..........#######.................#",
    "#..................................#",
    "txt_placeholder"
  ]
}
