{
  "width": 36,
  "height": 20,
  "ground": [
    "....................................",
    "....................................",
    "....................................",
    "....................................",
    "....................................",
    "W....................O..............",
    "W...................................",
    "W...................................",
    "W...................................",
    "W...................................",
    "W...................................",
    "W...................................",
    "....................................",
    "....................................",
    ".....S..............................",
    "....................................",
    "....................................",
    "....................................",
    "....................................",
    "..............WWWWWWWWWW............"
  ],
  "walls": [
    "####################################",
    "#..................................#",
    "#.................#######..........#",
    "#.................#.....#..........#",
    "#.................#.....#..........#",
    "#.................#.....#..........#",
    "#.................#.....#..........#",
    "#.................#.....#..........#",
    "#.................#.....#..........#",
    "#.................#.....#..........#",
    "#.................#.....#..........#",
    "#..################.....#..........#",
    "#..#...................l#..........#",
    "#..#..................l#k..........#",
    "#..#.................l#k...........#",
    "#..#................l#k............#",
    "#..#...............l#k.............#",
    "#..#################k..............#",
    "#..................................#",
    "####################################"
  ]
}