{
  "width": 36,
  "height": 20,
  "ground": [
    "....................................",
    "....................................",
    "....................................",
    "....................................",
    "....................................",
    ".....................O..............",
    "....................................",
    "....................................",
    "....................................",
    "....................................",
    "....................................",
    "....................................",
    "....................................",
    "....................................",
    ".....S..............................",
    "....................................",
    "....................................",
    "....................................",
    "....................................",
    "...................................."
  ],
  "walls": [
    "....................................",
    "....................................",
    "..................#######...........",
    "..................#.....#...........",
    "..................#.....#...........",
    "..................#.....#...........",
    "..................#.....#...........",
    "..................#.....#...........",
    "..................#.....#...........",
    "..................#.....#...........",
    "..................#.....#...........",
    "...################.....#...........",
    "...#...................l#...........",
    "...#..................l#k...........",
    "...#.................l#k............",
    "...#................l#k.............",
    "...#...............l#k..............",
    "...#################k...............",
    "....................................",
    "...................................."
  ]
}