{
  "width": 36,
  "height": 20,
  "ground": [
    "....................................",
    "....................................",
    "....................................",
    "...............>>>..................",
    "...............>>>..................",
    "...............>>>...........S......",
    "...............>>>..................",
    "...............>>>..................",
    "....................................",
    "....................................",
    "....................................",
    ".......^^^^^........................",
    ".......^^^^^........................",
    ".......^^^^^........................",
    ".........O..........................",
    "....................................",
    "....................................",
    "....................................",
    "....................................",
    "...................................."
  ],
  "walls": [
    "....................................",
    "....................................",
    "..........l#####################....",
    ".........l#k...................#....",
    "........l#k....................#....",
    ".......l#k.....................#....",
    "......l#k......................#....",
    "......#k.......................#....",
    "......#.....l###################....",
    "......#.....#.......................",
    "......#.....#.......................",
    "......#.....#.......................",
    "......#.....#.......................",
    "......#.....#.......................",
    "......#.....#.......................",
    "......#.....#.......................",
    "......#.....#.......................",
    "......#######.......................",
    "....................................",
    "...................................."
  ]
}