{
  "width": 35,
  "height": 21,
  "ground": [
    "...................................",
    "................WWWWWWWWWWWWWWWWWW.",
    "...............WWWWWWWWWWWWWWWWWWW.",
    "...............WWWWWWW..........WW.",
    "...............WWWWWWW..........WW.",
    "...............WWWWWWW..........WW.",
    "...............WWWWWWW..........WW.",
    "...............>.....<..........WW.",
    "...............>>>.<<<..........WW.",
    "...............>>>.<<<..........WW.",
    "..S............>>>.<<<.....O....WW.",
    "...............>>>.<<<..........WW.",
    "...............>>>.<<<..........WW.",
    "...............>WWWWW<..........WW.",
    "...............WWWWWWW..........WW.",
    "...............WWWWWWW..........WW.",
    "...............WWWWWWW..........WW.",
    "...............WWWWWWW..........WW.",
    "...............WWWWWWWWWWWWWWWWWWW.",
    "................WWWWWWWWWWWWWWWWWW.",
    "..................................."
  ],
  "walls": [
    "###################################",
    "#..............5###################",
    "#..............####################",
    "#..............#######1........2###",
    "#..............#######..........###",
    "#..............#######..........###",
    "#.......j......#######..........###",
    "#.......#j.....7#####8..........###",
    "#.......##j.....................###",
    "#.......###j....................###",
    "#.......####....................###",
    "#.......###k....................###",
    "#.......##k.....................###",
    "#.......#k.....5#####6..........###",
    "#.......k......#######..........###",
    "#..............#######..........###",
    "#..............#######..........###",
    "#..............#######3........4###",
    "#..............####################",
    "#..............7###################",
    "###################################"
  ]
}