{
  "width": 35,
  "height": 21,
  "ground": [
    "...................................",
    ".................................h.",
    "................................hW.",
    "...dAAAAb......................hWW.",
    "...AAAAAA.....................hWWW.",
    "...AAAAAA.WWf..............hWWWWWW.",
    "...AAAAAAWWWWf.........dAAbWWWWWWW.",
    "...aAAAAWWWWWW.........AAAAeWWWWWW.",
    "........WWWWWWf........AAAA.eWWWWW.",
    "........WWWWWWW........AAAA..evHWW.",
    "........WWWWWWW........AAAA...O<WW.",
    "........WWWWWWWf.......AAAA..h^FWW.",
    ".....S..WWWWWWWW.......AAAA.hWWWWW.",
    "........WWWWWWWW.......AAAAhWWWWWW.",
    ".......WWWWWWWWW.......aAAcWWWWWWW.",
    ".WWWWWWWWWWWWWWW...........eWWWWWW.",
    ".WWWWWWWWWWWWWWW..............eWWW.",
    ".WWWWWWWWWWWWWWWf..............eWW.",
    ".WWWWWWWWWWWWWWWWWWWf...........eW.",
    ".WWWWWWWWWWWWWWWWWWWWWWf.........e.",
    "..................................."
  ],
  "walls": [
    "###################################",
    "#.................i##k............#",
    "#..................##.............#",
    "#..................##.............#",
    "#.........lj.......##.............#",
    "#........l#k.......##.............#",
    "#.......l#k........##.............#",
    "#.......#k.........##.............#",
    "#.......#..........##.............#",
    "#.......#..........34.............#",
    "#.......#.........................#",
    "#.......#.........................#",
    "#.......#.........................#",
    "#......l#.........................#",
    "#j....l#k.........................#",
    "#######k..........................#",
    "#k................................#",
    "#.................................#",
    "#.................................#",
    "#.................................#",
    "###################################"
  ]
}