{
  "width": 36,
  "height": 20,
  "ground": [
    "...........WWWWWWWWWWWWW............",
    ".IvvvvvvvH<F^G>WWWWW>...............",
    ".>.S......<<.>>WWWW>I...............",
    ".>........<HvI.WWWW>G.........F^^^G.",
    ".G.............WWWWW^.^^^^^^^^^WWW^.",
    ".Ivvv.........<HvvvWW.WWWWWWWWWWWWW.",
    ".>I...............Hvv.WWWWWWWWWWWWW.",
    ".>.....F^^^^G......vv.......WIvvWWv.",
    ".>...F<FWWWW^^GG.........WW.W>AHvvI.",
    ".>..<FWWWWWWWWWGG...F^^^.WW.W>AAAAA.",
    ".A..AWWWWWIvvvWWG...<WWWWWW.vI......",
    ".A..AWWWWW>........^^WWWWWW....O.F^.",
    ".A..AWWWWW>.AAA.WWWWWWWv.vv......<W.",
    ".A..AWWWWW>.AAA.vvvHWWII........FFW.",
    ".>...HHWW>I........HvvI.........<WW.",
    ".>....HvAA......................<WW.",
    ".GG..........^^^G............F^^FWW.",
    ".GGG........FFW.^^^^^^^^^.^^^^WWWWW.",
    ".GGG^^^^^^^^<WW.WWWWWWWWW.WWWWWWWWW.",
    "..........................W........."
  ],
  "walls": [
    "####################################",
    "#..................................#",
    "#..................................#",
    "#.............#....................#",
    "#.#####..######......#.............#",
    "#....................#.............#",
    "#....................#.............#",
    "#....................#######.......#",
    "#.......................#..#.......#",
    "#.......................#..#.......#",
    "#..........................#.......#",
    "#...........#######.....#..#.......#",
    "#..........#...#........#..#.......#",
    "#..........#...#...........#.......#",
    "#..................................#",
    "#..................................#",
    "#........................#.........#",
    "#..............#.........#.........#",
    "#..............#.........#.........#",
    "####################################"
  ]
}