{
  "width": 36,
  "height": 21,
  "ground": [
    "....................................",
    "..................................O.",
    "....................................",
    "....................................",
    "....................................",
    "....................................",
    "....................................",
    "....................................",
    "....................................",
    ".=..................................",
    "....................................",
    "..................................=.",
    "....................................",
    "....................................",
    "....................................",
    "....................................",
    "....................................",
    "....................................",
    "....................................",
    ".S..................................",
    "...................................."
  ],
  "walls": [
    "####################################",
    "#..................................#",
    "#..................................#",
    "#..................................#",
    "#..................................#",
    "#..................................#",
    "#..................................#",
    "#..................................#",
    "#..................................#",
    "#..................................#",
    "####################################",
    "#..................................#",
    "#..................................#",
    "#..................................#",
    "#..................................#",
    "#..................................#",
    "#..................................#",
    "#..................................#",
    "#..................................#",
    "#..................................#",
    "####################################"
  ]
}