{
  "width": 36,
  "height": 19,
  "ground": [
    "....................................",
    "..............W.........A...........",
    "........................A...........",
    "....................................",
    "....................................",
    "W...................................",
    "W...................................",
    "W...................................",
    "W...........................AA....W.",
    "W.S.........................AA...OW.",
    "W...........................AA....W^",
    "W...................................",
    "....................................",
    "............................HHH.....",
    "...........................HHH......",
    "....................................",
    "........<<<<....>>...........WWWWW..",
    "........<<<<....>>...........WWWWW..",
    "..............WWWWWWWWWW............"
  ],
  "walls": [
    "####################################",
    "#k...........i.k...........i########",
    "#.....................8#....i#######",
    "#..##########...#########j...i######",
    "#..##########7.8##########j...i#####",
    "#..##############.....#####j...i####",
    "#..##############.....######j...####",
    "#..i######ki#####..#..#######j..####",
    "#..................#..............6#",
    "#.........##.......#...............#",
    "#.................8#7.............8#",
    "#...######jl##################...###",
    "#..##########################k.l####",
    "#..#########################k.l#####",
    "#..########################k.l######",
    "#..#######################k.l#######",
    "#..............................6####",
    "#j.............................8####",
    "####################################"
  ]
}