{
  "width": 36,
  "height": 19,
  "ground": [
    "....................................",
    "..............W.........A...........",
    "........................A...........",
    ".......................ww...........",
    "....wwwwwwww...........www..........",
    "W...wwwwwwwww..........wwww.........",
    "W...wwwwwwwwwwww.......wwwww........",
    "W...................................",
    "W...........................AA....W.",
    "W.S.........................AA...OW.",
    "W...........................AA....W^",
    "W.................www...............",
    "....wwwwwwwwwwwwwwwwwwwwwwwww.......",
    "....wwwwwwwwwwwwwwwwwwwwwwwwHHH.....",
    "....wwwwwwwwwwwwwwwwwwwwwwwHHH......",
    "....................................",
    "........<<<<....>>...........WWWWW..",
    "........<<<<....>>...........WWWWW..",
    "..............WWWWWWWWWW............"
  ],
  "walls": [
    "####################################",
    "#k...........i.k...........i########",
    "#.....................8#....i#######",
    "#..##########...#######.ij...i######",
    "#..#........#7.8#######..ij...i#####",
    "#..#........i####.....#...ij...i####",
    "#..#......lj....#.....#....ij...####",
    "#..i######ki#####..#.l#######j..####",
    "#..................#..............6#",
    "#.........##.......#...............#",
    "#.................8#7.............8#",
    "#...######jl######k.i#########...###",
    "#..#k.....ik................lk.l####",
    "#..#.......................lk.l#####",
    "#..#......................lk.l######",
    "#..#######################k.l#######",
    "#..............................6####",
    "#j.............................8####",
    "####################################"
  ]
}