{
  "width": 36,
  "height": 19,
  "ground": [
    "....................................",
    ".www..................ĂwăA..........",
    ".wwwā............An....AAp...AĀwā...",
    ".wwwwA........Āwwāon.........AĂwwā..",
    ".wwwăA........wwwwāA.........oAnww..",
    "...AAp.......Awwwwă.........O..Aww..",
    ".............AĂwwă.............AĂă..",
    ".............oAA....................",
    "....................................",
    "......AAn...mAA....mAAAĀā...........",
    ".....Āwāon..AĀwwwā.AĀwwwwwāA........",
    "....ĀwwwāA..AĂwwwwwwwwwwwwwA........",
    "....wwwwwA....ĂwwwwwwwwwwwwA........",
    "....Ăwwwă.......ĂwwwwwwwwwăA........",
    "......Ăă..........AnĂwwwww..........",
    "...S......AĀā......oAA.Ăwă..........",
    "..........Aww.......................",
    "..........AĂă.....................Ā.",
    "...................................."
  ],
  "walls": [
    "####################################",
    "#..................................#",
    "#..................................#",
    "#..................................#",
    "#..................................#",
    "#..................................#",
    "#..................................#",
    "#..................................#",
    "#..................................#",
    "#..................................#",
    "#..................................#",
    "#..................................#",
    "#..................................#",
    "#..................................#",
    "#..................................#",
    "#..................................#",
    "#..................................#",
    "#..................................#",
    "####################################"
  ]
}