{
  "width": 35,
  "height": 19,
  "ground": [
    "...................................",
    "...................................",
    "...................................",
    "...................................",
    "......O............................",
    "...................................",
    "...................................",
    "...................................",
    "...................................",
    "...................................",
    "...................................",
    "...................................",
    "...................................",
    "...................................",
    ".....S.............................",
    "...................................",
    "...................................",
    "...................................",
    "..................................."
  ],
  "walls": [
    "...................................",
    "...#############################...",
    "...#......................N+####...",
    "...#.......................N+###...",
    "...#........................N+##...",
    "...#.........................N+#...",
    "...#..........................N#...",
    "...#######################.....#...",
    ".........................#.....#...",
    ".........................#.....#...",
    ".........................#.....#...",
    "...#######################.....#...",
    "...#..........................R#...",
    "...#.........................R+k...",
    "...#........................R+k....",
    "...#.......................R+k.....",
    "...#......................R+k......",
    "...########################k.......",
    "..................................."
  ]
}