{
  "width": 36,
  "height": 20,
  "ground": [
    "....................................",
    "....................................",
    "....................................",
    "....................................",
    "....................................",
    ".....................O..............",
    "....................................",
    "....................................",
    "....................................",
    "....................................",
    "....................................",
    "....................................",
    "....................................",
    "....................................",
    ".....S..............................",
    "....................................",
    "....................................",
    "....................................",
    "....................................",
    "...................................."
  ],
  "walls": [
    "....................................",
    "....................................",
    "..................#######...........",
    "..................#.....#...........",
    "..................#.....#...........",
    "..................#.....#...........",
    "..................#.....#...........",
    "..................#.....#...........",
    "..................#.....#...........",
    "..................#.....#...........",
    "..................#.....#...........",
    "...################.....#...........",
    "...#...................R#...........",
    "...#..................R+k...........",
    "...#.................R+k............",
    "...#................R+k.............",
    "...#...............R+k..............",
    "...#################k...............",
    "....................................",
    "...................................."
  ]
}