{
  "width": 37,
  "height": 21,
  "ground": [
    "..........eWWWWWWWWWWWWWWWg..........",
    "...........eWWWWWWWWWWWWWg...........",
    "............eWWWWWWWWWWWg............",
    ".............eWWWWWWWWWg.............",
    "..............eWWWWWWWg...........S..",
    "...O...........eWWWWWg...............",
    "................eWWWg................",
    ".....................................",
    ".....................................",
    ".....................................",
    ".....................................",
    ".....................................",
    ".....................................",
    ".....................................",
    "f...................................h",
    "Wf.................................hW",
    "WWf...............................hWW",
    "WWWf.............................hWWW",
    "WWWWf...........................hWWWW",
    "WWWWWf.........................hWWWWW",
    "WWWWWWf.......................hWWWWWW"
  ],
  "walls": [
    "###j.............................l###",
    "#.i#j...........................l#k.#",
    "#..i#j.........................l#k..#",
    "#...i#j.......................l#k...#",
    "#....i#j.....................l#k....#",
    "#.....i#j...................l#k.....#",
    "#j.....i#j.................l#k.....l#",
    "i#j.....i#j...............l#k.....l#k",
    ".i#j.....i#j.............l#k.....l#k.",
    "..i#j.....i#j...........l#k.....l#k..",
    "...i#j.....i#j.........l#k.....l#k...",
    "....i#j.....(~).......]~[.....l#k....",
    ".....i#j.....(~).....]~[.....l#k.....",
    "......i#j.....(~)...]~[.....l#k......",
    ".......i#).....(~+++~[.....]#k.......",
    "........i~).....(+~+[.....]~k........",
    ".........(~).............]~[.........",
    "..........(~)...........]~[..........",
    "...........(~).........]~[...........",
    "............(~+~+~+~+~+~[............",
    ".............(+++++++++[............."
  ]
}