{
  "width": 33,
  "height": 21,
  "ground": [
    ".................................",
    "......<<.................>>......",
    "......<<.................>>......",
    "......<<.O.............O.>>......",
    "......<<.................>>......",
    "......<<.................>>......",
    ".................................",
    "......WWWWW...........WWWWW......",
    "......WWWW.............WWWW......",
    "......WWW...............WWW......",
    "......WW.................WW.....^",
    "......W...................W......",
    ".................................",
    ".vvvv.......................vvvv.",
    ".>>>..S...................S..<<<.",
    "W...............................W",
    "WWWWWW.....................WWWWWW",
    "WWWWWWW...................WWWWWWW",
    "WWWWWWWWWWWWWW.....WWWWWWWWWWWWWW",
    "WWWWWWWWWWWWWWW...WWWWWWWWWWWWWWW",
    "WWWWWWWWWWWWWWWW.WWWWWWWWWWWWWWWW"
  ],
  "walls": [
    "#################################",
    "#k...K.....................J...i#",
    "#....K.....................J....#",
    "#....K........j...l........J....#",
    "#....K........#...#........J....#",
    "#....K........#...#........J....#",
    "#....##########...##########....#",
    "#....#....l#k.J...J.i#j....#....#",
    "#....#...l#k..J...J..i#j...#....#",
    "#....#..l#k...J...J...i#j..#....#",
    "#....#.l#k....J...J....i#j.#....#",
    "#....#l#MMMM###...###MMMM#j#....#",
    "#....##k....JJJ...KKK....i##....#",
    "#...l#k.....JJJ...KKK.....i#j...#",
    "#j..JJ......JJJ...KKK......KK..l#",
    "i#####j.....JJJ...KKK.....l#####k",
    ".....i#j....JJJ...KKK....l#k.....",
    "......i########...########k......",
    ".............i#j.l#k.............",
    "..............i###k..............",
    "...............i#k..............."
  ]
}