{
  "width": 39,
  "height": 20,
  "ground": [
    ".......................................",
    ".v<v<v<v<v<v<v<v<v<v<v<v<v<v<v<v<<<<<<.",
    ".<v<v<v<v<v<v<v<v<v<v<v<v<v<v<v<<<<<<<.",
    ".v<v<v<v<v<v<v<v<v<v<v<v<v<v<v<v<<<S<<.",
    ".vvv^vvv^vvv^vvv^vvv^vvv^vvv^vvv<<<<<<.",
    ".vvv.vvv.vvv.vvv.vvv.vvv.vvv.vvv.<<<<<.",
    ".......................................",
    ".......................................",
    "..................................dAb..",
    "..................O...............AWA..",
    "..................................AWA..",
    "..................................AWA..",
    "..................O...............AWA..",
    "..................................AWA..",
    "..................................AWA..",
    "..................O...............AWA..",
    "..................................AWA..",
    "..................................aAc..",
    "..O..............hOf...................",
    "......................................."
  ],
  "walls": [
    "#######################################",
    "#.....................................#",
    "#.....................................#",
    "#.....................................#",
    "#.....................................#",
    "#j.l#j.l#j.l#j.l#j.l#j.l#j.l#j.l#j....#",
    "#k.i#k.i#k.i#k.i#k.i#k.i#k.i#k.i#######",
    "#...#...#...#...#...#...#...#...#.....#",
    "#...#...#...#...#...#...#...#...#.....#",
    "#...#...#...#...#...#...#...#...#.....#",
    "#...#...#...#...#####...#...#...#.....#",
    "#...#...#...#...k...i...#...#...#.....#",
    "#...#...#...#...........#...#...#.....#",
    "#...#...#...#############...#...#.....#",
    "#...#...#...k...........i...#...#.....#",
    "#...#...#........l.j........#...#.....#",
    "#...#...#####################...#.....#",
    "#...#...k...................i...#.....#",
    "#...#...........................#.....#",
    "#######################################"
  ]
}