{
  "width": 39,
  "height": 20,
  "ground": [
    ".......................................",
    "................................wĄ.....",
    "................................w...O..",
    "...............................Āw......",
    "...............................ww.=....",
    ".WWWWWWWWWWWWWWWWx........=...ĀwwĆ...ć.",
    ".WWWWWWWWWWWWWWWWWWWx.........wwwwwwww.",
    ".WWWWWWWWWWWWWWWWWWWW........Āwwwwwă...",
    ".WWWWWWWWWWWWWWWWWWWWx.......wwwwă.....",
    ".WWWWWWWWWWWWWWWWWWWWW......Āwwă.......",
    ".................yWWWW......wă.........",
    "..............>>>.WWWz.................",
    "...S..........>>>.yz...................",
    "..............>>>......................",
    "..............>GG^^^^^^^^^^^^^^^^^^^^^.",
    "..............GGG^^^^^^^^^^^^^^^^^^^^^.",
    "...............GG^^^^^^^^^^^^^^^^^^^^^.",
    ".......................................",
    ".......................................",
    "......................................."
  ],
  "walls": [
    "#######################################",
    "#.....................................#",
    "#.....................................#",
    "#.....................................#",
    "#.....................................#",
    "#.....................................#",
    "#.....................................#",
    "#.....................................#",
    "#.....................................#",
    "#.....................................#",
    "#.....................................#",
    "#.....................................#",
    "#.....................................#",
    "#.....................................#",
    "#.....................................#",
    "#.....................................#",
    "#.....................................#",
    "#.....................................#",
    "#.....................................#",
    "#######################################"
  ]
}