{
  "width": 38,
  "height": 24,
  "ground": [
    "......................................",
    "......................................",
    ".|..S.......>.>.>.>.>.>.>.>.=.........",
    "......................................",
    "......................................",
    "......................................",
    "..................................IvvH",
    "................................=.IvvH",
    "..................................IvvH",
    "...................................IvH",
    "............F^^^^^č................>|<",
    "............<Đ...đ>...................",
    "............<.Č^č.>...................",
    "............<.<O>.>...................",
    "............<.Ďvď.>...................",
    "............<Ē...ē>...................",
    "............HvvvvvI...................",
    "......................................",
    "......................................",
    "......................................",
    "......................................",
    "......................................",
    "......................................",
    "......................................"
  ],
  "walls": [
    ".................................#....",
    "###########################j.....#....",
    "+.J........J.J.J.J.J.J.J.J.J.....####.",
    "+.J........################k..####..#.",
    "########....#................##.......",
    ".......#....#...............##........",
    ".......#....#.............##..........",
    ".......##...#............##...........",
    "........#...#............#........j...",
    "........#..######j......#.........#...",
    "........#..#5...........#.........#...",
    "........#..#.......j....#....#########",
    "........#..#.......#....#....#........",
    "........#..#.......#....#....#........",
    ".......#...#.......#....#....#........",
    "..#######..#.......#...##....#........",
    ".###.....###7.....8#...#.....#........",
    ".#..........#############....#........",
    ".#.....#########.......##....#........",
    ".#.....########..............#........",
    ".#...........................#........",
    ".#...........................#........",
    ".###############################......",
    "...............#############.........."
  ]
}