{
  "width": 39,
  "height": 26,
  "ground": [
    ".......................................",
    ".WW....................................",
    ".WW.S......<.<.<.<.<.<.<.<.............",
    ".WW....................................",
    ".WWW.........AAAA......................",
    ".WWWW........AAAc......................",
    ".WBCWW.......AAA..................=vvH.",
    ".W..WW.......AAAb.................IvvH.",
    ".WDEWW.......AAAA.................IvvH.",
    ".WWWWW.............................IvH.",
    ".WWWWW......F^^^^^č................>|<.",
    ".WWBCW......<Đ...đ>....................",
    ".WWDEW......<.Č^č.>...........WWWWWWWW.",
    ".WWWW.......<.<O>.>...........WWWWWWWW.",
    ".WWW........<.Ďvď.>...........WWBCWWWW.",
    "............<Ē...ē>.AAA.......WWDEWWWW.",
    "............HvvvvvI.AAA.......WWWWWWWW.",
    "........uWW...................WWWWWWWW.",
    ".......uWWWWWWW...............WWWWWBCW.",
    ".......yz.....................WWWWW..W.",
    "..............................WWWWW..W.",
    "..............................WWWWWDEW.",
    "......IIII....................WB.CWWWW.",
    "...G^F..Ļ>.>.>.>.>.>.>.>.>.=..WD.EWWWW.",
    "...G|F........................WWWWWWWW.",
    "......................................."
  ],
  "walls": [
    "#######################################",
    "#56#k.....l################k........i##",
    "#..#......K.K.K.K.K.K.K.K.K..........##",
    "#..#j.....i################j.........##",
    "#..3#j.....6#5.................l.....##",
    "#...i#j.....#.................lk.....##",
    "#....i#j....#............l####k.......#",
    "#.....##....#............##k..........#",
    "#.....##...8#7..........l#k.......j...#",
    "#.....##...######j......#k........#...#",
    "#.....##...#5...........#.........#...#",
    "#.....##...#.......j....#....l#########",
    "#....l#k...#.......#....#....#5......6#",
    "#...l#k....#.......#....#....#........#",
    "#7.l#k.....#.......#...l#....#........#",
    "####k......#.......#...#k....#........#",
    "##5........#7.....8#7.8#.....#........#",
    "##.........#############2....#........#",
    "##.............#k.\\\\\\..34....#........#",
    "##...........................#........#",
    "##...........................#........#",
    "##7...............\\\\\\........#........#",
    "####L#j..i################j..#........#",
    "###k.i#j..J.J.J.J.J.J.J.J.J..#........#",
    "###...####################k.8#7......8#",
    "###+++#################################"
  ]
}