{
  "width": 36,
  "height": 25,
  "ground": [
    "....................................",
    "....................................",
    ".......S.......F^^^^^^^^G...........",
    "...............<........>...........",
    "...............<.oAAAAn.>...........",
    "...............<........>...........",
    "...............HvvvvvvvvI...........",
    ".ġ.ģ..WWW...........................",
    ".v.v..WWW......................O....",
    ".v.v................................",
    ".v.v.WWg............................",
    ".v.v.W=.....................wwwwwww.",
    ".v.v.g.......................wwwwww.",
    ".v.v................?.........wwwww.",
    ".Ģ.Ġ...........................wwww.",
    "................G...............www.",
    "...............GGō...............ww.",
    "...............GGGG......WWW......w.",
    "...............|GG......WWWW........",
    "..................rAAAq..CWW........",
    "...................AAA....WW........",
    "...................AAA....WW........",
    ".An................AAA....WW.....=..",
    "./A......./?|.....tAAAs..EWW........",
    "...................................."
  ],
  "walls": [
    "####################################",
    "#\\.......####\\....................i#",
    "#........####......................#",
    "#........####......................#",
    "#........####..............lMMMMMMM#",
    "#........####..............#.......#",
    "#........####..............#.......#",
    "#...##...####.............l#.......#",
    "#...##7.8####..l############.......#",
    "#...#########..#############.......#",
    "#...#5.6####\\..###k...i#####\\.\\.\\.\\#",
    "#...#...i......##k.....i####j......#",
    "#...#7....l...\\##..........i#j.....#",
    "#...#############...........i#j....#",
    "#...#############............i#j...#",
    "#.............\\#k......l###j..i#j..#",
    "#.....................l#####j..i#j.#",
    "#.................l######k.i#...i#j#",
    "#.................######k...#j...i##",
    "#...........................##....i#",
    "#.#j........................##..#j.#",
    "#.i#.....l###j..............##j.ik.#",
    "#.....l#######j.............###j...#",
    "#..l######...##j...........l####j.8#",
    "####################################"
  ],
  "swapRadii": {
    "20,13": 7,
    "11,23": 10
  }
}