{
  "width": 36,
  "height": 21,
  "ground": [
    "....................................",
    "..............ôêêêêêêó..............",
    "...............êêêêêê...............",
    "...............êêêêêê...............",
    "..............öê....êõ..............",
    "....................................",
    "....................................",
    "....................................",
    "....................................",
    "....................................",
    "...S...êêêêêêê........êêêêêêê...O...",
    "....................................",
    "....................................",
    "....................................",
    ".........êê..............êê.........",
    ".........êêó............ôêê.........",
    ".........êê..............êê.........",
    ".........êê.....ôêêó.....êê.........",
    ".........êê......êê......êê.........",
    "........öêêõ....öêêõ....öêêõ........",
    "...................................."
  ],
  "walls": [
    "####################################",
    "#..................................#",
    "#..................................#",
    "#..................................#",
    "#..............l####j..............#",
    "#...........l##########j...........#",
    "#.........l##############j.........#",
    "#.......l##################j.......#",
    "#......l####################j......#",
    "#......######################......#",
    "#..................................#",
    "#......######################......#",
    "#......i####################k......#",
    "#.......i##################k.......#",
    "#.........i##############k.........#",
    "#...........i##########k...........#",
    "#..............i####k..............#",
    "#..................................#",
    "#..................................#",
    "#..................................#",
    "####################################"
  ]
}