{
  "width": 36,
  "height": 21,
  "ground": [
    "....................................",
    "....................................",
    "....................................",
    "....................................",
    ".........................êêêêêêê....",
    "........................êêêêêêêêê...",
    ".......................êêêêêêêêêêê..",
    "......................êêêêêêêêêêêêê.",
    ".....þ..þþþþþþþþþ.þþþþ..............",
    ".....þþ.þþþþþþþþþ.þþþþ..............",
    "...S.þþþþþþþþþþþþþþþþþ..............",
    ".....þþþþþþþ.þþþþþþþþþ..............",
    ".....þþþþþþ..þþþþþþþþ...............",
    "................þþ..................",
    "............................O.......",
    "....................................",
    "....................................",
    "....................................",
    "....................................",
    "....................................",
    "...................................."
  ],
  "walls": [
    "####################################",
    "#..................................#",
    "#j.................................#",
    "##j.....................l#######j..#",
    "###j...................l#k.....i#j.#",
    "#ki#j.................l#k.......i#j#",
    "#..i#j...............l#k.........i##",
    "#...i#################k...........i#",
    "#....i##.......i##.................#",
    "#.....i#........i#.................#",
    "#......i....l....i.................#",
    "#..........l#........l.............#",
    "#.........l##.......l#.............#",
    "#...l#################j...........l#",
    "#..l#k...............i#j.........l##",
    "#jl#k.................i#j.......l#k#",
    "###k...................i#j.....l#k.#",
    "##k.....................i#######k..#",
    "#k.................................#",
    "#..................................#",
    "####################################"
  ]
}