{
  "width": 36,
  "height": 21,
  "ground": [
    "....................................",
    "....................................",
    "....................................",
    "....................................",
    ".........................AAAAAAA....",
    "........................AAAAAAAAA...",
    ".......................AAAAAAAAAAA..",
    "......................AAAAAAAAAAAAA.",
    "....................................",
    "....................................",
    "..O.................................",
    "....................................",
    "....................................",
    "....................................",
    "............................O.......",
    "....................................",
    "....................................",
    "....................................",
    "....................................",
    "....................................",
    "...................................."
  ],
  "walls": [
    "####################################",
    "#..................................#",
    "#..................................#",
    "##.......................#######...#",
    "#i#.....................#k.....i#..#",
    "#.i#...................#k.......i#.#",
    "#..i#.................#k.........i##",
    "#...i#################k...........i#",
    "#....i###......i###................#",
    "#.....i##.......i##................#",
    "#......i#...l#...i#................#",
    "#..........l##.......l.............#",
    "#.........l###......l#.............#",
    "#...l#################j...........l#",
    "#..l#.................#j.........l##",
    "#.l#...................#j.......l#.#",
    "#l#.....................#j.....l#..#",
    "##.......................#######...#",
    "#..................................#",
    "#..................................#",
    "####################################"
  ]
}