{
  "width": 36,
  "height": 21,
  "ground": [
    "....................................",
    "....................................",
    "....................................",
    "....................................",
    "....................................",
    "....................................",
    "....................................",
    "....................................",
    ".....þ...þþþþþþþþ..þþþ..............",
    ".....þþ..þþþþþþþþ..þþþ..............",
    "..O..þþþ.þþþþ.þþþþþþþþ..............",
    ".....þþþþþþþ..þþþþþþþþ..............",
    ".....þþþþþþ...þþþþþþþ...............",
    "................þþ..................",
    "............................O.......",
    "....................................",
    "....................................",
    "....................................",
    "....................................",
    "....................................",
    "...................................."
  ],
  "walls": [
    "####################################",
    "#..................................#",
    "#..................................#",
    "##.......................#######...#",
    "#i#.....................#.......#..#",
    "#.i#...................#.........#.#",
    "#..i#.................#...........##",
    "#...i#################.............#",
    "#....i###......i###................#",
    "#.....i##.......i##................#",
    "#......i#...l#...i#................#",
    "#..........l##.......l.............#",
    "#.........l###......l#.............#",
    "#...l#################j...........l#",
    "#..l#.................#j.........l##",
    "#.l#...................#j.......l#.#",
    "#l#.....................#j.....l#..#",
    "##.......................#######...#",
    "#..................................#",
    "#..................................#",
    "####################################"
  ]
}