{
  "width": 36,
  "height": 21,
  "ground": [
    "....................................",
    ".WWWWWWWWWWWWWWWWWWWWWWWWWWWWWWWWWW.",
    ".WWWWWWWWWWWWWWWWWWWWWWWWWWW.....WW.",
    ".WWWWþþþþWWWWWWWWWþþWWWWWWW.......W.",
    ".WWWWWþþþþWWWWWWWþþWWWWWWWWþ......W.",
    ".WWWWWWWWWWWWWWWWWWWWWWþþþþþ..O...W.",
    ".WWWWWWWWWWWWWWWWWWWWWþþþþþþ......W.",
    ".WWWWWWWWWWWWWWWWW.þþþþþþþW.......W.",
    ".WWWWWWWWWWWWWWWW.þþþþþþWWWW.....WW.",
    ".WWþþþþWWWWWWWW..þþþþWàWWWWWWWWWWWWW",
    ".WWWþþþþWWWWWW.þþþþþþàWWWWWWWWWWWWWW",
    ".WWWWWWWWWWWWþþþþþþþ.WWWWWWWWWþþWWWW",
    ".WW.....WWWWþþþþþþ..WWWWWWWWWþþþþWWW",
    ".W.......Wþþþþþþ..WWWWWWWWWWWþþþþWWW",
    ".W......þþþþþþþ.WWWWWWWWWWWþþþþþþWWW",
    ".W......þþþþWWWWWWWWWWWWWWþþþþþþþWWW",
    ".W..S...þþþWWWWWWWþþþþWWWWþþþþþþþWWW",
    ".W......þWWWWWWWWþþþþþWWWWWWþþþþWWWW",
    ".WW.....WWWWWWWWWþþþþWWWWWWWWWWWWWW.",
    ".WWWWWWWWWWWWWWWWWWWWWWWWWWWWWWWWWW.",
    "...................................."
  ],
  "walls": [
    "####################################",
    "#..................................#",
    "#..........................1#####2.#",
    "#..........................#5...6#.#",
    "#................................#.#",
    "#................................#.#",
    "#................................#.#",
    "#................]~[.......#7...8#.#",
    "#...............]~[........3#####4.#",
    "#.............]~~[.................#",
    "#............]~[....]..............#",
    "#..................]~..............#",
    "#.1#####2........]~~[..............#",
    "#.#5...6#......]~~[................#",
    "#.#...........]~[..................#",
    "#.#................................#",
    "#.#................................#",
    "#.#7...8#..........................#",
    "#.3#####4..........................#",
    "#..................................#",
    "####################################"
  ],
  "groundLayers": [
    [
      "....................................",
      "....................................",
      ".....áß.............................",
      ".........ß.......á..................",
      ".....Þ.............à......á.........",
      "......................á.............",
      ".....................á..............",
      "..........................à.........",
      "........................à...........",
      ".......ß.............àW.............",
      "...Þ.................W..............",
      "............á................á..ß...",
      "...........á........................",
      ".........á..................á.......",
      "..........................á.........",
      "............à.......................",
      "...........à.....á..................",
      "...........................Þ....à...",
      ".....................à..............",
      "....................................",
      "...................................."
    ]
  ]
}