{
  "width": 36,
  "height": 21,
  "ground": [
    "WWWWWWWWWWWWWWWWWWWWWWWWWWWWWWWWWWWW",
    "WWWW.............................WWW",
    "WWW.....êêêêêêêêêêêêêê<<<<<<.....WWW",
    "WWW.....êêêêêêêêêêêêêê>>>>>>...O.WWW",
    "WWW.....êêêêêêêêêêêêêê<<<<<<.....WWW",
    "WWW.....êêêêêêêêêêêêêê>>>>>>.....WWW",
    "WWW.....êêêêêêêêêêêêêê<<<<<<.....WWW",
    "WWW.....êêêêêêêêêêêêêê>>>>>>.....WWW",
    "WWW..............................WWW",
    "WWW......WWWWWWWWWWWWWWWWWWWWWWWWWWW",
    "WWW......WWWWWWWWWWWWWWWWWWWWWWWWWWW",
    "WWW......WWWWWWWWWWWWWWWWWWWWWWWWWWW",
    "WWW......................WWWW....WWW",
    "WWW...........>>>........WWW......WW",
    "WWW...........>>>.......WWW....S..WW",
    "WWW...................WWWW........WW",
    "WWW.........WWWW..................WW",
    "WWW........WWWWW......>>>.........WW",
    "WWW.......WWWWW.......>>>.........WW",
    "WWWW.....WWWWWW..................WWW",
    "WWWWWWWWWWWWWWWWWWWWWWWWWWWWWWWWWWWW"
  ],
  "walls": [
    "....................................",
    "...l#############################j..",
    "...#+P..........................i#..",
    "...#+Q...........................#..",
    "...#+P...........................#..",
    "...#+Q...........................#..",
    "...#+P...........................#..",
    "...#+Q..........................l#..",
    "...#Q...#########################k..",
    "...#....#k..........................",
    "...#....#...........................",
    "...#....#j..........................",
    "...#...1#################j..l####j..",
    "...#...34....K..........lk.lk....#..",
    "...#.........K........l#k.l#.....#..",
    "...#........l####....lk..l#k.....#..",
    "...#.......lk...#....####k.......#..",
    "...#......lk...lk....K...........#..",
    "...#j...l#k...lk.....K...........#..",
    "...i#####k....i##################k..",
    "...................................."
  ]
}