{
  "width": 35,
  "height": 27,
  "ground": [
    "WWWWWWWWWWWWWWWWWþþþþþþþþþþþþþþWWWW",
    "WWWWWWWWWWWWWWWWþþþþþ.....þþþþþþWWW",
    "WWWWWWWWWWWWWWþþþþþ.H<<<<F.þþþþþþþW",
    "WWWþþþþþþþWWWþþþþþ.HH<<<<FF.þþþþþþW",
    "WWþþþþþþþþþþþþþþþ.HHH<..<FFF.þþþþþW",
    "Wþþþþþþþþþþþþþþþ.HHHH.þþ.FFFF.þþþþþ",
    "Wþþþþ...þþþþþþþ.vvvH.þþþþ.F^^^.þþþþ",
    "þþþþ.....þþþþþþ.vvv.þþþþþþ.^^^.þþþþ",
    "þþþ.......þþþþþ.vvv.þþþþþþ.^^^.þþþþ",
    "þþ.........................^^^.þþþþ",
    "þ...........îþþþWWWþþþ.........þþþþ",
    "......þ....îêþþþWWWþþþ..........þþþ",
    "...S..þ....êêþþ=WWW←þþ..........þþþ",
    "......þ....ëêþþþWWWþþþ..........þþþ",
    "þ...........ëþþþWWWþþþ.........þþþþ",
    "þþ.............................þþþþ",
    "þþþ.......þþþþþ.^^^.þþþþþþþþþþþþþþþ",
    "þþþþ.....þþþþþþ.^^^.þþWWþþþ.......þ",
    "þþþþþ...þþþþþþþ.^^^.þþWWþþ.....ŖHH.",
    "Wþþþþþþþþþþþþþþ.^^^.þþþþþ.......ŖH.",
    "WWþþþþþþþþþþþþþ........þþ........Ŗ.",
    "WWWWþþþþþþþþþþþ....................",
    "WWWWWþþþWWWWWþþ..............êêì...",
    "WWWWWWWWWWWWWþþþ.............êOê...",
    "WWWWWWWWWWWWWþþþþþþ..........êêí...",
    "WWWWWWWWWWWWWWþþþþþþþþþþþþþþ......þ",
    "WWWWWWWWWWWWWWWþþþþþþþþþþþþþþþþþþþþ"
  ],
  "walls": [
    "...................................",
    "...................l######j........",
    "..................l#k....i#j.......",
    ".................l#k......i#j......",
    "................l#k..l##j..i#j.....",
    "...............l#k..l#ki#j..i#j....",
    "....l###j......#k..l#k..i#j..i#....",
    "...l#####j.....#...#k....i#...#....",
    "..l#k...i#j....#...#j....l#...#....",
    ".l#k.....i#################...#....",
    "l#k..1#2......................+P...",
    "#k...#.#......................++...",
    "#....#.#......................++...",
    "#j...#.#......................++...",
    "i#j..3#4......................+Q...",
    ".i#j.....l#####################....",
    "..i#j...l#k....#...#...............",
    "...i#####k.....#...#......l#######j",
    "....i###k......#...#.....l#k.....i#",
    "...............#...#j....#k.......#",
    "...............#...i###jl#........#",
    "...............#......i###..###...#",
    "...............###j.........#.....#",
    "...............i#####j.....l#.....#",
    "..................i##########....l#",
    "...........................i######k",
    "..................................."
  ],
  "groundLayers": [
    [
      "................á..............ß...",
      "...............á................ß..",
      ".............á.....................",
      "..á.......ß.á......................",
      ".á................................ß",
      "...................................",
      "á..................................",
      "...................................",
      ".................|.................",
      "...................................",
      "................ß..................",
      "..................á................",
      "...............þà..þ...............",
      "................ß..................",
      "..................á................",
      "...................................",
      ".................↑.................",
      "......................àÞ...........",
      "......................ßá...........",
      "Þ..................................",
      ".Þ.................................",
      "...Þ...............................",
      "....Þ...à...Þ......................",
      "..............................ê....",
      "...................................",
      ".............Þ.....................",
      "..............Þ...................."
    ]
  ]
}