{
  "width": 38,
  "height": 26,
  "ground": [
    "......................................",
    "......................................",
    "......................................",
    "..........................îì..........",
    ".........................îWWì.........",
    "........................îêWWí.........",
    "......................îêêWWí..........",
    ".....................îêWWWí...........",
    ".....................êWŪWê............",
    "....................îêWWWí............",
    "...................îêWêêí.............",
    "..................îêWêí...............",
    ".................îêWêí................",
    ".................êWWê.................",
    ".................êWêí.................",
    "..................Wí..................",
    ".................WW...................",
    "....Ę^^^GGG^ę....W....................",
    "....^^^GGGG^^.........................",
    "....^^GGGG^^^.........................",
    "....^^GOGG^^^.........................",
    "....^^GGG^^^^.........................",
    "....Ě^^^^^^^ě..................S..į<..",
    ".................................į<Į^.",
    "................................į<Į^^.",
    "......................................"
  ],
  "walls": [
    "......................#########.......",
    "...................####k.....i###.....",
    "..................##k.........i##.....",
    ".................#k............i#.....",
    "................#k..............#.....",
    "...............##...............#.....",
    "...............#................#.....",
    "...............#................#.....",
    "..............##................#.....",
    "..............#k................#.....",
    "..............#................l#.....",
    ".............##...............l##.....",
    ".............#k..............l##......",
    ".........#####............l####.......",
    "......####.............l####..........",
    "...####..........#j...l#..............",
    "...#............l##...#...............",
    "..##...........l##k...#...............",
    ".##............##k....#...............",
    ".#.............#k.....i###########....",
    ".#.............#j...............i###..",
    ".#.............##j................i##.",
    ".#............##.##j...............i##",
    ".##.........##....####j.............i#",
    "..##......###........######j........l#",
    "...########...............############"
  ],
  "groundLayers": [
    [
      "......................................",
      "......................................",
      "......................................",
      "......................................",
      "..........................íë..........",
      ".........................h.î..........",
      "........................h.î...........",
      "......................h..î............",
      "......................................",
      ".....................h..î.............",
      "....................h.g...............",
      "...................h.g................",
      "..................h.g.................",
      "......................................",
      "...................g..................",
      "......................................",
      "......................................",
      ".......ŏ...Ŏ..........................",
      "......ŏ...............................",
      "..........Ŏ...........................",
      "......................................",
      ".........Ŏ............................",
      "......................................",
      "...................................ė..",
      "..................................ė...",
      "......................................"
    ]
  ],
  "bhRadii": {
    "23,8": 9
  }
}