{
  "width": 38,
  "height": 26,
  "ground": [
    "......................................",
    "......................................",
    "......................................",
    "........................îêêêì.........",
    "........................êêWWê.........",
    ".......................îêêWWê.........",
    "......................îêêWWêí.........",
    ".....................îêWWWêí..........",
    "....................îêWŪWêí...........",
    "...................îêêWWWí............",
    "..................îêêWêêí.............",
    ".................îêêWêêí..............",
    ".................êêWêêí...............",
    ".................êWWêí................",
    ".................êWêê.................",
    ".................êWêê.................",
    ".................WWêí.................",
    "....Ę^^^GGG^ę....Wg.ŘH................",
    "....^^^GGGG^^....gŘHHŗ................",
    "....^^GGGG^^^.....Hŗ<<<...............",
    "....^^GOGG^^^.....Ġ<Į..ĸ>Ĺ............",
    "....^^GGG^^^^..........vĸ>>Ĺ..........",
    "....Ě^^^^^^^ě..........Ġvvĸ>...S..į<..",
    ".................................į<Į^.",
    "................................į<Į^^.",
    "......................................"
  ],
  "walls": [
    "......................#########.......",
    "...................####k.....i###.....",
    "..................##k.........i##.....",
    ".................#k............i#.....",
    "................#k..............#.....",
    "...............##...............#.....",
    "...............#................#.....",
    "...............#................#.....",
    "..............##................#.....",
    "..............#k................#.....",
    "..............#................l#.....",
    ".............##...............l##.....",
    ".............#k..............l##......",
    ".........#####............l####.......",
    "......####.............l####..........",
    "...####...............l#..............",
    "...#............l.....#...............",
    "..##...........l#.....#...............",
    ".##............##.....#...............",
    ".#.............#k.....i###########....",
    ".#.............#j...............i###..",
    ".#.............##j................i##.",
    ".#............##.##j...............i##",
    ".##.........##....####j.............i#",
    "..##......###........######j........l#",
    "...########...............############"
  ],
  "groundLayers": [
    [
      "......................................",
      "......................................",
      "......................................",
      "......................................",
      "..........................íë..........",
      ".........................h.î..........",
      "........................h.î...........",
      "......................h..î............",
      "......................................",
      ".....................h..î.............",
      "....................h.g...............",
      "...................h.g................",
      "..................h.g.................",
      "......................................",
      "...................g..................",
      ".................h....................",
      "......................................",
      ".......ŏ...Ŏ..........................",
      "......ŏ..............į................",
      "..........Ŏ........į..................",
      ".......................ġ..............",
      ".........Ŏ..............ġ.............",
      "..........................ġ...........",
      "...................................ė..",
      "..................................ė...",
      "......................................"
    ]
  ],
  "bhRadii": {
    "23,8": 9
  }
}