{
  "width": 31,
  "height": 21,
  "ground": [
    "...............................",
    "...............................",
    "...............................",
    "...............................",
    "...............................",
    "...............................",
    "...............................",
    "...............................",
    "...............................",
    ".........S.....................",
    "...............................",
    "...............................",
    "...............................",
    "...............................",
    "...............................",
    "...............................",
    "...............................",
    "...............................",
    "...............................",
    "...............................",
    "..............................."
  ],
  "walls": [
    "...............................",
    "...............................",
    "...............................",
    "...............................",
    "...............................",
    "...............................",
    "...............................",
    "...........1#####2.............",
    "...........JJJJJJJ.............",
    "...........3#####4.............",
    "...............................",
    "...............................",
    "...............................",
    "...............................",
    "...............................",
    "...............................",
    "...............................",
    "...............................",
    "...............................",
    "...............................",
    "..............................."
  ]
}