{
  "width": 30,
  "height": 20,
  "ground": [
    "..............................",
    "..............wwww............",
    "..............................",
    "..............................",
    "..............................",
    "..............................",
    ".....................S........",
    "..............................",
    "..............................",
    "....................IIvvvHHH..",
    "...................IIIvvvHHH..",
    "...................IIIvvvHHH..",
    ".O...........b.....>>>IvH<<<..",
    "...............d...>>>>.<<<<..",
    ".vvvvvvvvvvvvvv....>>>G^F<<<..",
    ".vvvvvvvvvvvvvv..h.GGG^^^FFF..",
    ".vvvvvvvvvvvvvv....GGG^^^FFF..",
    ".=vvvvvvvvvvvvv..G.GGG^^^FFF..",
    ".>>>>>>>>>>>>>>>......=.......",
    ".............................."
  ],
  "walls": [
    "##############################",
    "#............................#",
    "#..5###6.....................#",
    "#..#1.2#...##................#",
    "#..#.#.#+..##....#j.........~#",
    "#..#.#.#+#.KK.....#.........~#",
    "#..#.#.#+..##....6......~...~#",
    "#..#.#.#...##..........$_....#",
    "####.#.#........#......~.....#",
    "#...4#.#.....................#",
    "#####8.#.....................#",
    "#............................#",
    "#............i...............#",
    "#..............i............~#",
    "#...........................~#",
    "#................i..........~#",
    "#...........................~#",
    "#................i..........~#",
    "#......................++++++#",
    "##############################"
  ]
}