{
  "width": 30,
  "height": 20,
  "ground": [
    "..............................",
    "..............................",
    "..............................",
    "..............................",
    "..............................",
    "..............................",
    "..............................",
    "....S.........................",
    "..............................",
    "..............................",
    "..............................",
    "..............................",
    "..............................",
    "..............................",
    "..............................",
    "..............................",
    "..............................",
    "..............................",
    "..............................",
    ".............................."
  ],
  "walls": [
    ".........i........k.i.........",
    ".........i........k.i.........",
    ".........i........k.i.........",
    ".........i........k.i.........",
    ".........i........k.i.........",
    ".........i........k.i.........",
    ".........i........k.i.........",
    "..i..i...i........k.i.........",
    ".....i...i........k.i.........",
    ".........i........k.i.........",
    ".........i........k.i.........",
    ".........i........k.i.........",
    ".........i........k.i.........",
    ".........i........k.i.........",
    ".........i........k.i.........",
    ".........i........k.i.........",
    ".........i........k.i.........",
    ".........i........k.i.........",
    ".........i........k.i.........",
    ".........i........k.i........."
  ]
}