{
  "width": 31,
  "height": 21,
  "ground": [
    "...............................",
    "...............................",
    "................WWg............",
    "..............yWWW.............",
    ".....S.........WW..............",
    ".........s......B..............",
    "........mAAAc....Ė.............",
    ".........AAA...................",
    "...............................",
    "...............................",
    "..................Ū............",
    "...............................",
    "...............................",
    "............`..................",
    "..........Ăww\".................",
    "............wwwwĄ..............",
    ".............www...............",
    "...............................",
    "...............................",
    "...............................",
    "..............................."
  ],
  "walls": [
    "...............................",
    "...............................",
    "...+..+........................",
    "...+..+........................",
    "...+..+........................",
    "...+..+.......##..........##...",
    "...+..+.......#................",
    "...+..+......##........##......",
    "...+..+......##........###.....",
    ".......U......#........###.....",
    "..............##.......##......",
    "...............##.......##.....",
    "....~....}......##.......###...",
    ".................##..####..##..",
    ".......1#k........####..####...",
    ".......##7.........#...........",
    "...............................",
    "...............................",
    "...............................",
    "...............................",
    "..............................."
  ],
  "bhRadii": {
    "18,10": 8
  }
}