{
  "width": 30,
  "height": 20,
  "ground": [
    "..............................",
    "..............................",
    "...................S..........",
    "..............................",
    "..............................",
    "..............................",
    "..............................",
    "..............................",
    "..............................",
    "..............................",
    "..............................",
    "..............................",
    "..............................",
    "..............................",
    "..............................",
    "..............................",
    "..............................",
    "..............................",
    "..............................",
    ".............................."
  ],
  "walls": [
    "..................k.l.........",
    "..................k.l.........",
    "..................k.l.........",
    "..................k.l.........",
    "..................k.l.........",
    "..................k.l.........",
    "..................k.l.........",
    ".....i............k.l.........",
    ".....i............k.l.........",
    "..................k.l.........",
    "..................k.l.........",
    "..................k.l.........",
    "..................k.l.........",
    "..................k.l.........",
    "..................k.l.........",
    "..................k.l.........",
    "..................k.l.........",
    "..................k.l.........",
    "..................k.l.........",
    "..................k.l........."
  ]
}