{
  "width": 31,
  "height": 21,
  "ground": [
    "...............................",
    "...............................",
    "................WWg............",
    "..............yWWW.............",
    "...............WW..............",
    ".........s......B..............",
    "........mAAAc.......ņ^^^ō......",
    ".........AAA........<...>......",
    "....................<...>......",
    "....................<...>......",
    "....................Ŗvvvš......",
    "...vvv.........................",
    "...vvv......................O..",
    "............`..................",
    "..........Ăww\".................",
    "............wwwwĄ..............",
    ".............www.....S.........",
    "...............................",
    "...................WWWW........",
    "...................WWWW........",
    "..............................."
  ],
  "walls": [
    "...............................",
    "...............................",
    "...+..+........................",
    "...+..+........................",
    "...+..+........................",
    "...+..+.......##...............",
    "...+..+.......#................",
    "...+..+......##................",
    "...+..+......##................",
    ".......U......#................",
    "..............##...............",
    "..#...#........##..............",
    "..#...#..}......##.............",
    "..#k.i#..........#######.......",
    ".......1#k........#....#.......",
    ".......##7........#....#.......",
    "..................#....#.......",
    "..................#....#.......",
    "..................#....#.......",
    "...............................",
    "..............................."
  ]
}