{
  "width": 30,
  "height": 20,
  "ground": [
    "..............................",
    "..............wwww............",
    "..............................",
    "..............AAAA............",
    "..............AAAA...A........",
    "..............AAAA............",
    ".....................S........",
    "..............................",
    "..............................",
    "....................IIvvvHHH..",
    "...................IIIvvvHHH..",
    "...................IIIvvvHHH..",
    ".O.................>>>IvH<<<..",
    "...................>>>>.<<<<..",
    ".vvvvvvvvvvvvvv....>>>G^F<<<..",
    ".vvvvvvvvvvvvvv....GGG^^^FFF..",
    ".vvvvvvvvvvvvvv....GGG^^^FFF..",
    ".=vvvvvvvvvvvvv....GGG^^^FFF..",
    ".>>>>>>>>>>>>>>>......=.......",
    ".............................."
  ],
  "walls": [
    "##############################",
    "#............................#",
    "#..5###6.....................#",
    "#..#1.2#...##................#",
    "#..#.#.#+..##........k..~...~#",
    "#..#.#.#+#.KK...........~...~#",
    "#..#.#.#+..##...........~...~#",
    "#..#.#.#...##..........$~....#",
    "####.#.#...............~~....#",
    "#...4#.#......R++Z...........#",
    "#####8.#......++++...........#",
    "#............................#",
    "#............................#",
    "#...........................~#",
    "#...........................~#",
    "#...........................~#",
    "#...........................~#",
    "#...........................~#",
    "#......................++++++#",
    "##############################"
  ]
}