{
  "width": 30,
  "height": 20,
  "ground": [
    "..............................",
    "...................S..........",
    "..............................",
    "..............................",
    "..............................",
    "..............................",
    "..............................",
    "..............................",
    "..............................",
    "..............................",
    "..............................",
    "..............................",
    "...........?..................",
    "..............................",
    "..............................",
    "..............................",
    "..............................",
    "..............................",
    "..............................",
    ".............................."
  ],
  "walls": [
    "..................k.i.........",
    "..................k.i.........",
    "..................k.i.........",
    "..................k.i.........",
    "..................k.i.........",
    "..................k.i.........",
    "..................k.i.........",
    ".........#........k.i.........",
    "..................k.i.........",
    "..................k.i.........",
    "..................k.i.........",
    "..................k.i.........",
    "..................k.i.........",
    "..................k.i.........",
    "..................k.i.........",
    "..................k.i.........",
    "..................k.i.........",
    "..................k.i.........",
    "..................k.i.........",
    "..................k.i........."
  ]
}