{
  "width": 31,
  "height": 21,
  "ground": [
    "...............................",
    "...............................",
    "...............................",
    "...............................",
    "...............................",
    "...............................",
    "...............................",
    "....................Ū..S.......",
    "...............................",
    "...............................",
    "...............................",
    "...............................",
    "...............................",
    "...............................",
    "...............................",
    "...............................",
    "...............................",
    "............?..................",
    "...............................",
    "...............................",
    "..............................."
  ],
  "walls": [
    "...............................",
    "...............................",
    "...............................",
    "...............................",
    "...............................",
    "..............##..........##...",
    "..............#................",
    ".............##.........#......",
    ".............##........###.....",
    ".......U......#........###.....",
    "..............##.......##......",
    "...............##.......##.....",
    "....~....}......##.......###...",
    ".................##..####..##..",
    "..................####..####...",
    "...................#...........",
    "...............................",
    "...............................",
    "...............................",
    "...............................",
    "..............................."
  ]
}