{
  "width": 30,
  "height": 80,
  "ground": [
    "I.S..O....=|/?Ū...............",
    "..............................",
    "..............................",
    "..............................",
    "..............................",
    "..............................",
    "..............................",
    "..............................",
    "..............................",
    "..............................",
    "..............................",
    "..............................",
    "..............................",
    "..............................",
    "..A...........................",
    "..abcd........................",
    "..mnop........................",
    "..qrst........................",
    "..............................",
    "..W...........................",
    "..efgh........................",
    "..uxyz........................",
    "..BCDE........................",
    "..............................",
    "..w...........................",
    "..':`\"........................",
    "..ĀāĂă........................",
    "..ĄąĆć........................",
    "..............................",
    "..ĈĉĊċ........................",
    "..ČčĎď........................",
    "..ĐđĒē........................",
    "..............................",
    "..ĔĕĖė........................",
    "..ĘęĚě........................",
    "..ĜĝĞğ........................",
    "..............................",
    "..ĠġĢģ........................",
    "..ĤĥĦħ........................",
    "..ĨĩĪī........................",
    "..............................",
    "..ĬĭĮį........................",
    "..İıŨũ........................",
    "..ĴĵĶķ........................",
    "..............................",
    "..ĸĹĺĻ........................",
    "..ļĽľĿ........................",
    "..ŀŁłŃ........................",
    "..............................",
    "..ńŅņ.........................",
    "..Ňňŉ.........................",
    "..ŊŋŌ.........................",
    "..............................",
    "..ōŎŏ.........................",
    "..ŐőŒ.........................",
    "..œŔŕ.........................",
    "..............................",
    "..ŖŗŘ.........................",
    "..řŚś.........................",
    "..ŜŝŞ.........................",
    "..............................",
    "..şŠš.........................",
    "..ŢţŤ.........................",
    "..ťŦŧ.........................",
    "..............................",
    "..............................",
    "..............................",
    "..............................",
    "..^v<>........................",
    "..FGHI........................",
    "..............................",
    "..............................",
    "..............................",
    "..............................",
    "..............................",
    "..............................",
    "..............................",
    "..............................",
    "..............................",
    ".............................."
  ],
  "walls": [
    "5...................#+~\\......",
    "..............................",
    "..ijkl........................",
    "..NPQR........................",
    "..()[]........................",
    "..............................",
    "..1234........................",
    "..TUVX........................",
    "..{}@$........................",
    "..............................",
    "..5678........................",
    "..YZ09........................",
    "..%&*_........................",
    "..............................",
    "..............................",
    "..............................",
    "..............................",
    "..............................",
    "..............................",
    "..............................",
    "..............................",
    "..............................",
    "..............................",
    "..............................",
    "..............................",
    "..............................",
    "..............................",
    "..............................",
    "..............................",
    "..............................",
    "..............................",
    "..............................",
    "..............................",
    "..............................",
    "..............................",
    "..............................",
    "..............................",
    "..............................",
    "..............................",
    "..............................",
    "..............................",
    "..............................",
    "..............................",
    "..............................",
    "..............................",
    "..............................",
    "..............................",
    "..............................",
    "..............................",
    "..............................",
    "..............................",
    "..............................",
    "..............................",
    "..............................",
    "..............................",
    "..............................",
    "..............................",
    "..............................",
    "..............................",
    "..............................",
    "..............................",
    "..............................",
    "..............................",
    "..............................",
    "..............................",
    "..JKLM........................",
    "..-!,;........................",
    "..............................",
    "..............................",
    "..............................",
    "..............................",
    "..............................",
    "..............................",
    "..............................",
    "..............................",
    "..............................",
    "..............................",
    "..............................",
    "..............................",
    ".............................."
  ]
}