{
  "width": 30,
  "height": 21,
  "ground": [
    "..............................",
    "..............................",
    "..............................",
    "..............................",
    "..............................",
    "..............................",
    "..............................",
    "..............................",
    "..............................",
    "..............................",
    "..S........................O..",
    "..............................",
    "..............................",
    "..............................",
    "..............................",
    "..............................",
    "..............................",
    "..............................",
    "..............................",
    "..............................",
    ".............................."
  ],
  "walls": [
    "##############################",
    "#i##########k.........i#######",
    "#.i#########...........i######",
    "#..i########............i#####",
    "#...i#######.............i####",
    "#....i######..............i###",
    "#.....i#####...............i##",
    "#......i####...l#####j......i#",
    "#..............#######.......#",
    "#..............##1.2##.......#",
    "#..............##...##.......#",
    "#..............##3.4##.......#",
    "#..............#######.......#",
    "#......l####...i#####k......l#",
    "#.....l#####...............l##",
    "#....l######..............l###",
    "#...l#######.............l####",
    "#..l########............l#####",
    "#.l#########...........l######",
    "#l##########j.........l#######",
    "##############################"
  ]
}