{
  "width": 35,
  "height": 21,
  "ground": [
    "...................................",
    "...............uWWWWWWWWWWWWWWWWWW.",
    "...............WWWWWWWWWWWWWWWWWWW.",
    "...............WWWWWWWB........CWW.",
    "...............WWWWWWW..........WW.",
    "...............WWWWWWW..........WW.",
    "........f......WWWWWWW..........WW.",
    "........Wf.....yWWWWWz..........WW.",
    "........WWf....<<<.>>>..........WW.",
    "........WWWf...<<<.>>>..........WW.",
    "..S.....WWWW...<<<.>>>.....O....WW.",
    "........WWWg...<<<.>>>..........WW.",
    "........WWg....<<<.>>>..........WW.",
    "........Wg.....uWWWWWx..........WW.",
    "........g......WWWWWWW..........WW.",
    "...............WWWWWWW..........WW.",
    "...............WWWWWWW..........WW.",
    "...............WWWWWWWD........EWW.",
    "...............WWWWWWWWWWWWWWWWWWW.",
    "...............yWWWWWWWWWWWWWWWWWW.",
    "..................................."
  ],
  "walls": [
    "###################################",
    "#.................................#",
    "#.................................#",
    "#.................................#",
    "#.................................#",
    "#.................................#",
    "#.................................#",
    "#.................................#",
    "#.................................#",
    "#.................................#",
    "#.................................#",
    "#.................................#",
    "#.................................#",
    "#.................................#",
    "#.................................#",
    "#.................................#",
    "#.................................#",
    "#.................................#",
    "#.................................#",
    "#.................................#",
    "###################################"
  ]
}