{
  "width": 38,
  "height": 22,
  "ground": [
    "......................................",
    "......................................",
    "......................................",
    "......................................",
    "......................................",
    "......................................",
    "......................................",
    "......................................",
    "......................................",
    "......................................",
    ".............................O........",
    ".....S................................",
    "......................................",
    "......................................",
    "......................................",
    "......................................",
    "......................................",
    "......................................",
    "......................................",
    "......................................",
    "......................................",
    "......................................"
  ],
  "walls": [
    "######################################",
    "#....................................#",
    "#....................................#",
    "#........................l######j....#",
    "#.......................l#k....i#j...#",
    "#......................l#k......i#j..#",
    "#.....................l#k........i#j.#",
    "#.#####################k..........i#.#",
    "#.#...............###k.............#.#",
    "#.#...............##k..............#.#",
    "#.#...............#k...............#.#",
    "#.#..........#j....................#.#",
    "#.#..........##j...................#.#",
    "#.#..........###j..................#.#",
    "#.#####################j..........l#.#",
    "#.....................i#j........l#k.#",
    "#......................i#j......l#k..#",
    "#.......................i#j....l#k...#",
    "#........................i######k....#",
    "#....................................#",
    "#....................................#",
    "######################################"
  ]
}