{
  "width": 36,
  "height": 21,
  "ground": [
    "....................................",
    "....................................",
    "....................................",
    "....................................",
    "....O...............................",
    "....................................",
    "....................................",
    "....................................",
    "....................................",
    "....................................",
    "....................................",
    "....................................",
    "...................................w",
    "...................................w",
    "...................................w",
    "................................S..w",
    "...................................w",
    "...................................w",
    ".......uWx.........................w",
    ".....EWWWWWD........................",
    "...................................."
  ],
  "walls": [
    "####################################",
    "#.......#..........................#",
    "#.......#..........................#",
    "#.......#..........................#",
    "#.......#..........................#",
    "#.......#..........................#",
    "#.......#..........................#",
    "#.......#..........................#",
    "#.......#..........................#",
    "#.......#..........................#",
    "#.......#..........................#",
    "#.......############################",
    "#..................................#",
    "#.......#..........................#",
    "#.......#..........................#",
    "#.......#..........................#",
    "#j......#..........................#",
    "##j................................#",
    "###j...............................#",
    "####j..............................#",
    "####################################"
  ]
}