{
  "width": 19,
  "height": 35,
  "ground": [
    "...................",
    "...................",
    "...................",
    "....vvv............",
    "....vvv............",
    "....vvv............",
    "....vvv............",
    "....vvv..........^.",
    ".................^.",
    ".................^.",
    ".................^.",
    ".................^.",
    ".................^.",
    ".................^.",
    ".................^.",
    ".................^.",
    ".................^.",
    ".................^.",
    ".................^.",
    ".................^.",
    ".................^.",
    ".................^.",
    ".................^.",
    ".................^.",
    ".......m.n.......^.",
    ".^......A......v.^.",
    ".^.....o.p.....v.^.",
    ".^.............v.^.",
    ".^.............v.^.",
    ".^...............^.",
    ".................^.",
    ".................^.",
    "........O........S.",
    "......WWWWW........",
    "..................."
  ],
  "walls": [
    "###################",
    "###k...........i###",
    "##k.............i##",
    "##...............i#",
    "##.j...l.....5#6..#",
    "#1.#...#.....N+#..#",
    "#3.k...i......N8..#",
    "##..............l.#",
    "##.......YZ.....#.#",
    "##P......09.....#.#",
    "##+P............#.#",
    "##++P...........#.#",
    "####k...........#.#",
    "###k..YZ....YZ..#.#",
    "##k...09....09..#.#",
    "#k..............#.#",
    "#...............#.#",
    "#...............#.#",
    "#..j.........l..#.#",
    "#..#.........#..#.#",
    "#..#P.......R#..#.#",
    "#..#+P.....R+#..#.#",
    "#..i##.....##k..#.#",
    "#...............#.#",
    "#...............#.#",
    "#..j.........l..#.#",
    "#..ij.......lk..#.#",
    "#...ij.....lk...#.#",
    "#....ij...lk....#.#",
    "#j....ij.lk....l#.#",
    "##j...........l##.#",
    "###j.........l###.#",
    "####j.......l####.#",
    "#####j.....l#####.#",
    "###################"
  ]
}