{
  "width": 30,
  "height": 20,
  "ground": [
    "..............................",
    "..............................",
    "..............................",
    ".........................O....",
    "..............................",
    "..............................",
    "..............................",
    "..............................",
    "..............................",
    "......................b.......",
    "......................Ab......",
    "......................AA......",
    "...................aAAAc......",
    "....................aAc.......",
    "..............................",
    "...S..........................",
    "..............................",
    "..............................",
    "..............................",
    ".............................."
  ],
  "walls": [
    "##############################",
    "##....##......##...#.##k...i##",
    "##.##.####.#####.#.#.#k.....i#",
    "#..............#.#.#.#.......#",
    "#.############.#.#.#.#.......#",
    "#............#.#.#.#.#.......#",
    "############.#.#.#.#.........#",
    "#.........##.#.#.#.#.#.......#",
    "#.#.#####.##.#.#.#.#.#.......#",
    "#.#.......##.#.#.#.#.#.......#",
    "#...#.###....#...#...#......l#",
    "#####.################.....l##",
    "#..........................i##",
    "#...........................i#",
    "#............................#",
    "#............................#",
    "#............................#",
    "#...........................l#",
    "#..........................l##",
    "##############################"
  ]
}