{
  "width": 36,
  "height": 19,
  "ground": [
    "....................................",
    ".HHHHvvvvvvvvvvvvvvvvvvv.vvvvvvvvvv.",
    ".HHHHvvvvvvvvvvvvvvvvvvv.vvvvvvvvvv.",
    ".HHHHvvvvvvvvvvvvvvvvvvv.vvvvvvvvvv.",
    ".HHHHvvvvvv.vvvvvvvvvvvv.vvvvvvvvvv.",
    ".HHHHvvvvvv.vvvvvvvvvvvvvvvvvvvvvvv.",
    "..HHHvvvvvv.vvvvvvvvvvvvvvvvvvvvvvv.",
    "...HHvvvvvv.vvvvvvvvvvvvvvvvvvvvvvv.",
    "....Hvvvvvv.vvvvvvvvvvvvvvvvvvvvvvv.",
    "..S.................................",
    "....F^^^^^^.^^^^^^^^^^^^^^^^^^^^^^^.",
    "...FF^^^^^^.^^^^^^^^^^^^^^^^^.^^^^^^",
    "..FFF^^^^^^.^^^^^^^^^^^^^^^^^.^^^^^.",
    ".FFFF^^^^^^.^^^^^^^^^^^^^^^^^.......",
    ".FFFF^^^^^^.^^^^^^^^^^^^^^^^^.......",
    ".FFFF^^^^^^^^^^^^^^^^^^^^^^^^...O...",
    ".FFFF^^^^^^^^^^^^^^^^^^^^^^^^.......",
    ".FFFF^^^^^^^^^^^^^^^^^^^^^^^^.......",
    ".FFFF^^^^^^^^^^^^^^^^^^^^^^^^......."
  ],
  "walls": [
    "####################################",
    "#.......................#..........#",
    "#.......................#..........#",
    "#.......................#..........#",
    "#.......................#..........#",
    "#..........#.......................#",
    "#..........#.......................#",
    "#..........#.......................#",
    "#..........#.......................#",
    "#..........#.......................#",
    "#..........#.......................#",
    "#..........#.................#.....#",
    "#..........#.................#.....#",
    "#..........#.................#.....#",
    "#............................#.....#",
    "#............................#.....#",
    "#............................#.....#",
    "#............................#.....#",
    "####################################"
  ]
}