{
  "width": 35,
  "height": 20,
  "ground": [
    "...................................",
    ".WWWWWWWWWWWWWWWWWWWWWWWWWWWWWWWWW.",
    ".WW.............................WW.",
    ".W.............<<..>.............W.",
    ".W.............<<.>>.............W.",
    "WW.............<<.>>.............W.",
    "WW.............<<.>>.............W.",
    "WW.............<<..>.............W.",
    "WW...............................W.",
    "WW...............................W.",
    "WW........uWx.uWx.uWx.uWx........W.",
    "WW........W.W.W.W.W.W.W.W........W^",
    ".W........W.W.W.W.W.W.W.W........W.",
    ".W........W.W.W.W.W.W.W.W........W.",
    ".W...S....W.W.W.W.W.W.W.W....O...W.",
    ".W........W.W.W.W.W.W.W.W........W.",
    ".W........W.yWz.yWz.yWz.W........W.",
    ".WW......EWD...........EWD......WW.",
    ".WWWWWWWWWWWWWWWWWWWWWWWWWWWWWWWWW.",
    "..............WWWWWWWWWW..........."
  ],
  "walls": [
    "###################################",
    "#k...............................i#",
    "#.l#############################j.#",
    "#.####k.......i#####k.......i####.#",
    "#.###k.......................i###.#",
    "#.##k.........................i##.#",
    "#.#k...........................i#.#",
    "#.#...........l#####j...........#.#",
    "#.#.....l#################j.....#.#",
    "#.#.....#k................#.....#.#",
    "#.#.....#.................#.....#.#",
    "#.#.....#.................#.....#.#",
    "#.#.....#.................#.....#.#",
    "#.#.....#.................#.....#.#",
    "#.#.....#.................#.....#.#",
    "#.#.....#.................#.....#.#",
    "#.#j...l#.................#j...l#.#",
    "#.i#####k.................i#####k.#",
    "#j...............................l#",
    "###################################"
  ]
}