{
  "width": 36,
  "height": 28,
  "ground": [
    "....................................",
    "..S....................S............",
    ".....S..............................",
    "....................................",
    "..^^^^^.....v......^^^^^^^..........",
    "..^^^^^.....v......^^^^^^^..........",
    "............v.......................",
    "..WWWWW.......v.........WWWWW.......",
    "..WWWWW.......v.........WWWWW.......",
    "....................................",
    "..........?.........................",
    "...............Ū....................",
    "....................................",
    "...........=........=...............",
    "....................................",
    "..wwwwww...............wwwwwwww.....",
    "..wwwwww...............wwwwwwww.....",
    "....................................",
    ".........AAAAAA.....AAAAAA..........",
    ".........AAAAAA.....AAAAAA..........",
    "....................................",
    ".................O..................",
    "....................................",
    "....................................",
    "....................................",
    "....................................",
    "....................................",
    "...................................."
  ],
  "walls": [
    "####################################",
    "#..................................#",
    "#..................................#",
    "#..................................#",
    "#..i####k....+.....+....i####k.....#",
    "#..................................#",
    "#..................................#",
    "#..l####j....+.....+....l####j.....#",
    "#..................................#",
    "#..................................#",
    "#...........i####k.................#",
    "#..................................#",
    "#..................................#",
    "#...........l####j.................#",
    "#..................................#",
    "#..J.........................K.....#",
    "#..i####j.................l####k...#",
    "#..................................#",
    "#..................................#",
    "#..............l####j..............#",
    "#.........1...........2............#",
    "#..................................#",
    "#..................................#",
    "#.........3...........4............#",
    "#..................................#",
    "#..................................#",
    "#..................................#",
    "####################################"
  ]
}