{
  "width": 35,
  "height": 24,
  "ground": [
    "...........WWWWWWWWWWWWW...........",
    ".WWWWWWWWWWWWWWWWWWWWWWWWWWWWWWWWW.",
    ".WWWWWWg.eWWWWWWWWWWWWWWWWWWWWWWWW.",
    ".WWWWWg...eWWWWWWWWWWWWWWWWWWWWWWW.",
    ".WWWWg.....eWWWWWWWWWWWWWWWWWWWWWW.",
    ".WWWg.......eWWWWWWWWWWWWWWWWWWWWW.",
    ".WWg..S....hfeWWWWWWWWWWWWWWWWWWWW.",
    ".Wg.......hWWfeWWWWWWWWWWWWWWWWWWW.",
    ".W........eWWWfeWWWg..eWWWWWWWWWWW.",
    ".Wf........eWWWfeWg....eWWWWWWWWWW.",
    ".WWf...hf...eWWWf.......eWWWWWWWWW.",
    ".WWWf.hWWf...eWWg...hf...eWWWWWWWW.",
    ".WWWWWWWWWf...eg....WWf...eWWg.eWW.",
    ".WWWWWWWWWWf......hfeWWf...eg...eWW",
    ".WWWWWWWWWWWf....hWWfeWWf......O.eW",
    ".WWWWWWWWWWWWf..hWWWWfeWWf........e",
    ".WWWWWWWWWWWWWWWWWWWWWfeWg.......h.",
    ".WWWWWWWWWWWWWWWWWWWWWWf........hWh",
    ".WWWWWWWWWWWWWWWWWWWWWWW.......hWWW",
    ".WWWWWWWWWWWWWWWWWWWWWWWf.O...hWWWW",
    ".WWWWWWWWWWWWWWWWWWWWWWWWf...hWWWW.",
    ".WWWWWWWWWWWWWWWWWWWWWWWWWf.hWWWWW.",
    ".WWWWWWWWWWWWWWWWWWWWWWWWWWWWWWWWW.",
    "..........................WWWWWWWWW"
  ],
  "walls": [
    "###################################",
    "#.................................#",
    "#.................................#",
    "#.................................#",
    "#.................................#",
    "#.................................#",
    "#.................................#",
    "#.................................#",
    "#.................................#",
    "#.................................#",
    "#.................................#",
    "#.................................#",
    "#.................................#",
    "#.................................#",
    "#.................................#",
    "#.................................#",
    "#.................................#",
    "#.................................#",
    "#.................................#",
    "#.................................#",
    "#.................................#",
    "#.................................#",
    "#.................................#",
    "###################################"
  ]
}