{
  "width": 36,
  "height": 21,
  "ground": [
    "...........WWWWWWWWWWWWW............",
    ".IvH.....dAAAcvvvvvvvvaAAAb.....IvH.",
    ".>O.....dAAAc..........aAAAb.....O<.",
    ".G.....dAAAc..F.....G...aAAAb.....F.",
    "...uWx.AAAc..FF.....GG...aAAA.uWx...",
    "...WWW.oAc..FF.......GG...aAp.WWW...",
    "...WWW.....FF.hx...uf.GG......WWW...",
    "...WWW.>>.FF.hWg...eWf.GG..<<.WWW...",
    "...WWW.>>....ygF^^^Gez.....<<.WWW...",
    "...WWW.>>......<mAn>.......<<.WWW...",
    "...WWW.>>......<ASA>.......<<.WWW...",
    "...WWW.>>......<oAp>.......<<.WWW...",
    "...WWW.>>....ufHvvvIhx.....<<.WWW...",
    "...WWW.>>.HH.eWf...hWg.II..<<.WWW...",
    "...WWW.....HH.ez...yg.II......WWW...",
    "...WWW.mAb..HH.......II..dAn..WWW...",
    "...yWz.AAAb..HH.....II..dAAA..yWz...",
    ".I.....aAAAb..H.....I..dAAAc......H.",
    ".>O.....aAAAb.........dAAAc......O<.",
    ".G^F.....aAAAb^^^^^^^dAAAc......G^F.",
    "...................................."
  ],
  "walls": [
    "####################################",
    "#..................................#",
    "#..................................#",
    "#..............5###6...............#",
    "#..............7###8...............#",
    "#..................................#",
    "#..................................#",
    "#..................................#",
    "#.........56...........56..........#",
    "#.........##...........##..........#",
    "#.........##...........##..........#",
    "#.........##...........##..........#",
    "#.........78...........78..........#",
    "#..................................#",
    "#..................................#",
    "#..................................#",
    "#..............5###6...............#",
    "#..............7###8...............#",
    "#..................................#",
    "#..................................#",
    "####################################"
  ]
}