{
  "width": 36,
  "height": 19,
  "ground": [
    "....................................",
    "..............W.........A...........",
    "........................A...........",
    "....................................",
    "....................................",
    "W...................................",
    "W...................................",
    "W...................................",
    "W...........................AA....W.",
    "W.S.........................AA...OW.",
    "W...........................AA....W^",
    "W...................................",
    "....................................",
    "............................HHH.....",
    "...........................HHH......",
    "....................................",
    "........<<<<....>>>>.........WWWWW..",
    "........<<<<....>>>>.........WWWWW..",
    "..............WWWWWWWWWW............"
  ],
  "walls": [
    "####################################",
    "#k...........i.k...........i########",
    "#.....................##....i#######",
    "#..##########...#########j...i######",
    "#..##########3.4##########j...i#####",
    "#..##############.....#####j...i####",
    "#..##############.....######j...####",
    "#..i######ki#####..#..#######j..####",
    "#..................#..............2#",
    "#.........#........#...............#",
    "#..................#..............4#",
    "#...######jl##################...###",
    "#..##########################...####",
    "#..#########################...#####",
    "#..########################...######",
    "#..#######################...#######",
    "#..............................2####",
    "#j.............................4####",
    "####################################"
  ]
}