{
  "width": 36,
  "height": 19,
  "ground": [
    "....................................",
    ".www..................Ăwă...........",
    ".wwwā.........................Āwā...",
    ".wwww.........Āwwā............Ăwwā..",
    ".wwwă.........wwwwā.............ww..",
    "..............wwwwă.........O...ww..",
    "..............Ăwwă..............Ăă..",
    "....................................",
    "....................................",
    ".......................Āā...........",
    ".....Āwā.....Āwwwā..Āwwwwwā.........",
    "....Āwwwā....Ăwwwwwwwwwwwww.........",
    "....wwwww.....Ăwwwwwwwwwwww.........",
    "....Ăwwwă.......Ăwwwwwwwwwă.........",
    "......Ăă............Ăwwwww..........",
    "...S.......Āā..........Ăwă..........",
    "...........ww.......................",
    "...........Ăă.....................Ā.",
    "...................................."
  ],
  "walls": [
    "####################################",
    "#..................................#",
    "#..................................#",
    "#..................................#",
    "#..................................#",
    "#..................................#",
    "#..................................#",
    "#..................................#",
    "#..................................#",
    "#..................................#",
    "#..................................#",
    "#..................................#",
    "#..................................#",
    "#..................................#",
    "#..................................#",
    "#..................................#",
    "#..................................#",
    "#..................................#",
    "####################################"
  ]
}