{
  "width": 30,
  "height": 20,
  "ground": [
    "..............................",
    "..............................",
    "..............................",
    "..............................",
    "..............................",
    "..............................",
    "..............................",
    "..............S...............",
    "..............................",
    "..............................",
    "..............................",
    "..............................",
    "...........?..................",
    "..............................",
    "..............................",
    "..............................",
    "..............................",
    "..............................",
    "..............................",
    ".............................."
  ],
  "walls": [
    "..............................",
    "..............................",
    "..............................",
    "..............................",
    "..............................",
    "................l.............",
    "................#.............",
    "..............................",
    "................l.............",
    "...............l..............",
    "..............................",
    "..............................",
    "..............................",
    "..............................",
    "..............................",
    "..............................",
    "..............................",
    "..............................",
    "..............................",
    ".............................."
  ]
}