{
  "width": 38,
  "height": 22,
  "ground": [
    "......................................",
    ".WWWWWWWWWWWWWWWWWWWWWWWWWWWWWWWWWWWW.",
    ".W..................................W.",
    ".W..................................W.",
    ".W..................................W.",
    ".W..................................W.",
    ".W..................................W.",
    ".W..................................W.",
    ".W..................................W.",
    ".W..^^^^^^^^^.^^^^^^^^^.^^^^^^^^^^^.W.",
    ".W..<<<<<<<<<<<<<<<<<<<<<<<<<<<<<<<.W.",
    ".W..<<<<<<<<<<<<<<<<<<<<<<<<<<<<<<<.W.",
    ".W.......vvvvvvvvv.vvvvvvvvv.vvvvvv.W.",
    ".W..................................W.",
    ".W..................................W.",
    ".W..................................W.",
    ".W..............................S...W.",
    ".W..O...............................W.",
    ".W..................................W.",
    ".W..................................W.",
    ".WWWWWWWWWWWWWWWWWWWWWWWWWWWWWWWWWWWW.",
    "......................................"
  ],
  "walls": [
    "######################################",
    "#....................................#",
    "#.##################################.#",
    "#.#..........#.........#...........#.#",
    "#.#..........#.........#...........#.#",
    "#.#..........#.........#...........#.#",
    "#.#..........#.........#...........#.#",
    "#.#..........#.........#...........#.#",
    "#.k..........#.........#...........#.#",
    "#............#.........#...........#.#",
    "#..................................#.#",
    "#..................................#.#",
    "#.......#.........#.........#......#.#",
    "#.j.....#.........#.........#......#.#",
    "#.#.....#.........#.........#......#.#",
    "#.#.....#.........#.........#......#.#",
    "#.#.....#.........#.........#......#.#",
    "#.#.....#.........#.........#......#.#",
    "#.#.....#.........#.........#......#.#",
    "#.##################################.#",
    "#....................................#",
    "######################################"
  ]
}