{
  "width": 36,
  "height": 21,
  "ground": [
    "....................................",
    "....................................",
    "....................................",
    "...S...........................FFH..",
    "......IIIvvvvvvvvvvvvvvvvHHH...F.I..",
    ".....IIIIvvvvvvvvvvvvvvvvHHHH..HII..",
    ".....IIIIvvvvvvvvvvvuWfvvHHHH.......",
    ".....IIhWWWWWWWWWWWWgCWWxHH<<.......",
    "....>>>WWWWWWWWWWWWW..WWz<<<<.......",
    "...>>>>WWĀwwwwāWWWWW...db<<<........",
    "...>>>>WWwwwwwwWWWWzO.dAc<<<........",
    "...>>>>WWĂwăWWWWWg...dAc<<<<........",
    "....>>>yWWWWWWg^^^^.dAcFF<<<........",
    ".....GGGeWWz^^^^^^^dAcFFF<<.........",
    ".....GGGG^^^^^^^^^^acFFFF...........",
    "......GGG^^^^^^^^^^^FFFFF....FFH....",
    ".......GG^^^^^^^^^^^FFF......F.I....",
    ".............................HII....",
    "....................................",
    "....................................",
    "...................................."
  ],
  "walls": [
    "####################################",
    "#..................................#",
    "#..................................#",
    "#..................................#",
    "#..................................#",
    "#..................................#",
    "#..................................#",
    "#..................................#",
    "#..................................#",
    "#..................................#",
    "#..................................#",
    "#..................................#",
    "#..................................#",
    "#..................................#",
    "#..................................#",
    "#..................................#",
    "#..................................#",
    "#..................................#",
    "#..................................#",
    "#..................................#",
    "####################################"
  ]
}