{
  "width": 38,
  "height": 22,
  "ground": [
    "......................................",
    ".=....................................",
    "......................................",
    "......................................",
    "......................................",
    "......................................",
    "......S...............................",
    "......................................",
    "......................................",
    "......................................",
    "......................................",
    "......................................",
    "......................................",
    "......................................",
    "......O...............................",
    "......................................",
    "......................................",
    "......................................",
    "......................................",
    "......................................",
    "....................................=.",
    "......................................"
  ],
  "walls": [
    "######################################",
    "#.#.......\\.........\\........\\......2#",
    "#.#.......J.........K........J.......#",
    "#.#.......J.........K........J.....\\.#",
    "#.#.......J.........K........J.....#.#",
    "#.#.......J.........K........J.....#.#",
    "#.#.......J.........K........J.....#.#",
    "#.#.......J.........K........J.....#.#",
    "#.#.......J.........K........J.....#.#",
    "#.#.......J.........K........J.....#.#",
    "#.#LLLLLLL\\MMMMMMMMM\\LLLLLLLL\\MMMMM#.#",
    "#.#.......J.........J........K.....#.#",
    "#.#.......J.........J........K.....#.#",
    "#.#.......J.........J........K.....#.#",
    "#.#.......J.........J........K.....#.#",
    "#.#.......J.........J........K.....#.#",
    "#.#.......J.........J........K.....#.#",
    "#.#.......J.........J........K.....#.#",
    "#.\\.......J.........J........K.....#.#",
    "#.........J.........J........K.....#.#",
    "#3........\\.........\\........\\.....#.#",
    "######################################"
  ]
}