{
  "width": 39,
  "height": 20,
  "ground": [
    ".......................................",
    ".vvvvvvvvvvvvvvvvvvvvvvvvvvvvvvv<<<<<<.",
    ".vvvvvvvvvvvvvvvvvvvvvvvvvvvvvvv<<<<<<.",
    ".vvvvvvvvvvvvvvvvvvvvvvvvvvvvvvv<<<S<<.",
    ".vvv^vvv^vvv^vvv^vvv^vvv^vvv^vvv<<<<<<.",
    "..v...v...v...v...v...v...v...v...<<<<.",
    ".......................................",
    ".......................................",
    ".......................................",
    "..................O....................",
    ".......................................",
    ".......................................",
    "..................O....................",
    ".......................................",
    ".......................................",
    "..................O....................",
    ".......................................",
    ".......................................",
    "..O..............hOf...................",
    "......................................."
  ],
  "walls": [
    "#######################################",
    "#.....................................#",
    "#.....................................#",
    "#.....................................#",
    "#.....................................#",
    "#j.l#j.l#j.l#j.l#j.l#j.l#j.l#j.l#j....#",
    "#k.i#k.i#k.i#k.i#k.i#k.i#k.i#k.i#######",
    "#...#...#...#...#...#...#...#...#######",
    "#...#...#...#...#...#...#...#...#######",
    "#...#...#...#...#...#...#...#...#######",
    "#...#...#...#...#####...#...#...#######",
    "#...#...#...#...k...i...#...#...#######",
    "#...#...#...#...........#...#...#######",
    "#...#...#...#############...#...#######",
    "#...#...#...k...........i...#...#######",
    "#...#...#........l.j........#...#######",
    "#...#...#####################...#######",
    "#...#...k...................i...#######",
    "#...#...........................#######",
    "#######################################"
  ]
}